[
	[1,1,1,1,1,1,1,1,1,1,1,1,1,1,1,1,1,1,1,1,1,1,1,1,1,1,1,1,1,1,1,1,1,1,1,1,1,1,1,1,1,1,1,1,1,1,1,1,1,1],
	[1,1,1,1,0,0,0,0,0,0,1,1,1,1,1,1,1,1,0,0,0,0,0,0,6,0,0,0,0,0,0,99,0,0,0,0,0,0,0,0,0,0,0,0,0,0,1,1,1,1],
	[1,1,1,0,0,0,0,43,72,0,0,1,1,1,1,1,1,0,0,0,0,0,0,0,6,0,0,0,0,0,0,99,0,0,0,0,0,0,0,0,0,0,0,0,0,0,0,1,1,1],
	[1,1,0,0,0,0,0,0,0,0,0,0,1,1,1,1,0,0,0,0,0,0,0,0,6,0,0,0,0,0,0,99,0,0,0,0,0,0,0,0,0,0,0,0,0,0,0,0,1,1],
	[1,0,0,0,73,0,0,0,0,21,0,0,0,1,1,0,0,0,0,0,0,0,0,0,6,0,0,0,0,0,0,99,0,0,0,0,0,0,0,0,0,0,0,0,0,0,0,0,0,1],
	[1,0,0,0,0,0,0,0,0,0,0,0,0,1,0,0,0,0,0,0,0,0,0,0,6,0,0,0,0,0,0,99,0,0,0,0,0,0,0,0,0,0,0,0,33,0,0,0,0,1],
	[1,0,44,0,22,0,0,0,0,42,0,0,0,1,0,0,0,0,14,0,0,0,35,0,6,0,0,0,0,0,0,99,0,0,0,0,0,0,0,0,0,0,0,0,13,0,0,0,0,1],
	[1,0,0,0,0,0,1,1,0,0,0,0,0,1,0,0,0,0,0,0,0,0,65,0,6,0,0,0,0,0,0,99,34,64,0,0,0,0,0,0,0,0,0,0,0,63,0,0,0,1],
	[1,0,0,0,0,0,1,1,0,0,0,0,0,1,0,0,0,0,0,0,0,0,0,1,1,1,1,1,1,1,1,1,1,1,1,1,1,1,1,1,1,1,0,0,0,0,0,0,0,1],
	[1,0,0,0,0,0,1,1,0,0,0,0,0,1,0,0,0,0,36,0,0,0,0,1,1,1,1,1,1,1,1,1,1,1,1,1,1,1,1,1,1,1,1,0,0,0,0,0,0,1],
	[1,0,0,0,0,0,1,1,0,0,0,0,0,1,0,0,0,0,0,0,0,66,0,0,0,0,0,0,0,0,0,0,0,0,0,0,0,0,0,0,1,1,1,0,0,0,0,0,0,1],
	[1,0,0,0,0,0,1,1,0,0,20,0,0,1,0,0,0,0,0,0,15,0,0,0,0,0,0,0,0,67,0,0,0,0,0,0,0,0,0,0,0,1,1,0,0,0,0,0,0,1],
	[1,0,0,0,0,0,1,1,0,0,71,0,0,1,1,0,0,0,0,0,0,0,37,0,0,0,0,0,0,0,0,16,0,0,0,0,0,0,0,0,0,0,1,0,0,0,0,0,0,1],
	[1,0,0,0,0,0,1,1,0,0,0,0,0,0,1,1,0,0,0,0,0,0,0,0,0,0,0,0,0,0,0,0,0,38,0,0,0,0,0,0,0,0,1,0,0,0,0,0,0,1],
	[1,0,0,0,0,0,1,1,0,0,0,41,0,0,0,1,1,0,0,0,0,0,0,0,0,0,0,0,0,0,0,0,68,0,0,0,0,0,0,0,0,0,1,0,0,0,0,0,0,1],
	[1,0,0,0,0,0,1,1,0,0,0,0,0,0,0,0,1,1,1,1,1,1,1,1,1,1,1,1,1,1,0,0,0,0,0,0,0,0,0,0,0,0,1,0,0,0,0,0,0,1],
	[1,0,0,0,0,0,1,1,0,0,0,0,0,0,0,0,0,1,1,1,1,1,1,1,1,1,1,1,1,1,0,0,0,0,0,0,0,0,0,0,0,0,1,0,0,0,0,0,0,1],
	[1,0,0,45,0,0,1,1,0,0,0,0,0,0,0,0,0,0,7,0,0,0,0,0,0,0,0,0,0,0,0,0,0,0,0,0,0,0,0,0,0,0,1,0,0,32,0,0,0,1],
	[1,8,8,8,8,8,1,1,0,0,0,0,70,19,40,0,0,0,7,0,0,0,0,0,0,0,0,0,0,0,69,17,39,0,0,0,0,0,0,0,0,0,1,0,0,0,0,0,0,1],
	[1,0,0,0,0,0,0,1,1,1,0,0,0,0,0,0,0,0,7,0,0,0,0,0,18,0,0,0,0,0,0,0,0,0,0,0,0,0,0,0,0,1,1,0,0,0,12,0,62,1],
	[1,0,0,0,74,0,0,0,1,1,1,0,0,0,0,0,0,0,7,0,0,0,0,0,0,0,0,0,0,0,0,0,0,0,0,0,0,0,0,0,1,1,0,0,0,0,0,0,0,1],
	[1,0,0,0,0,23,0,0,0,1,1,1,0,0,0,0,0,0,7,0,0,0,0,0,0,0,0,0,0,0,0,0,0,0,0,0,0,0,0,1,1,0,0,0,0,0,0,0,0,1],
	[1,0,0,0,0,0,0,0,0,0,1,1,1,1,1,1,1,1,1,1,1,1,1,1,1,1,1,1,1,1,1,1,1,1,1,1,1,1,1,1,0,0,0,0,0,0,0,0,0,1],
	[1,0,0,0,0,0,0,0,0,0,0,1,1,1,1,1,1,1,1,1,1,1,1,1,1,1,1,1,1,1,1,1,1,1,1,1,1,1,1,1,0,0,0,0,0,0,0,0,0,1],
	[1,0,0,0,0,0,0,75,0,0,0,0,0,0,0,0,0,0,0,0,0,0,0,0,0,47,0,0,0,0,0,0,0,0,0,0,0,5,0,0,0,0,31,0,0,0,0,0,0,1],
	[1,1,0,0,0,0,46,0,0,0,0,0,0,0,0,0,0,0,0,0,0,0,0,0,0,0,0,0,0,0,0,0,0,0,0,0,0,5,0,0,0,0,0,0,0,0,0,0,1,1],
	[1,1,1,0,0,0,0,0,0,24,0,0,0,0,0,0,0,0,0,0,0,0,0,0,0,0,0,0,0,0,0,0,0,0,0,0,0,5,0,0,0,0,0,11,0,0,0,1,1,1],
	[1,1,1,1,0,0,0,0,0,0,0,0,0,0,0,0,76,0,0,0,0,0,0,0,0,0,0,0,0,0,0,0,0,0,0,0,0,5,0,0,0,0,0,0,61,0,1,1,1,1],
	[1,1,1,1,1,0,0,0,0,0,0,0,0,0,0,0,1,1,1,1,1,1,1,1,1,1,1,1,1,1,1,1,1,1,1,1,1,1,1,1,1,1,1,1,1,1,1,1,1,1],
	[1,1,1,1,1,1,1,1,1,1,1,1,1,1,1,1,1,1,1,1,1,1,1,1,1,1,1,1,1,1,1,1,1,1,1,1,1,1,1,1,1,1,1,1,1,1,1,1,1,1]
]