[
	[1,1,1,1,1,1,1,1,1,1,1,1,1,1,1,1,1,1,1,1,1,1,1,1,1,1,1,1,1,1,1,1,1,1,1,1,1,1,1,1,1,1,1,1,1,1,1,1,1,1],
	[1,1,1,1,0,0,0,0,0,0,0,0,0,0,0,0,0,0,0,0,0,0,0,0,0,0,1,1,1,1,1,1,1,1,0,0,0,0,0,0,0,0,0,0,0,1,1,1,1,1],
	[1,1,1,0,71,19,41,0,0,0,0,0,0,0,0,0,0,0,0,0,0,0,0,0,70,0,0,1,1,1,1,1,1,0,0,0,0,0,0,0,0,0,0,0,0,0,1,1,1,1],
	[1,1,0,0,0,0,0,0,0,0,0,0,0,0,0,0,0,0,0,0,0,0,0,0,0,40,18,0,1,1,1,1,0,0,0,0,0,0,0,0,0,0,0,0,0,0,0,1,1,1],
	[1,0,0,0,0,0,0,0,1,1,1,1,1,1,1,1,1,1,1,1,1,1,1,1,0,0,0,0,1,1,1,0,0,13,35,0,0,0,0,0,0,0,0,0,0,34,0,1,1,1],
	[1,0,0,0,0,0,0,1,1,0,0,0,0,0,8,0,0,0,0,1,1,1,1,0,0,0,0,0,1,1,0,0,64,0,0,0,0,0,0,0,0,0,0,0,63,12,0,1,1,1],
	[1,0,0,0,42,0,1,1,0,0,0,0,0,0,8,0,0,0,0,0,1,1,0,0,0,0,0,1,1,0,0,0,0,0,0,0,0,1,1,1,1,1,0,0,0,0,0,1,1,1],
	[1,0,0,0,0,0,1,0,0,0,48,24,0,0,8,0,0,0,49,0,0,1,0,0,69,0,1,1,0,0,0,0,0,0,0,0,1,1,1,1,1,1,1,0,0,0,0,1,1,1],
	[1,0,0,0,0,0,1,0,0,77,0,0,0,0,8,0,0,25,78,0,0,1,0,17,0,0,1,0,0,0,0,0,0,0,0,1,1,1,1,1,1,1,1,1,0,0,0,1,1,1],
	[1,0,0,0,0,0,1,0,0,0,0,0,0,0,8,0,0,0,0,0,0,1,0,0,39,0,1,0,0,0,0,0,0,0,1,1,1,1,1,1,1,1,1,1,0,0,0,1,1,1],
	[1,0,0,0,0,0,1,0,0,0,0,0,0,1,1,1,0,0,0,0,0,1,0,0,0,0,1,0,0,14,36,0,0,1,1,1,1,1,1,1,1,1,1,1,0,0,0,1,1,1],
	[1,0,0,0,0,0,1,0,0,0,0,0,1,1,1,1,1,0,0,0,0,1,0,68,0,0,1,0,0,65,0,0,1,1,1,1,1,1,1,1,1,1,1,1,0,0,0,1,1,1],
	[1,7,7,7,7,7,1,0,0,0,0,1,1,1,1,1,1,0,0,0,0,1,6,6,6,6,1,0,0,0,0,0,1,1,1,1,1,1,1,1,1,1,1,1,2,2,2,1,1,1],
	[1,0,0,0,0,0,1,0,23,0,0,1,1,1,1,1,1,0,0,0,0,1,0,0,0,0,1,0,0,0,0,0,1,1,1,1,1,1,1,1,1,1,1,1,2,2,2,1,1,1],
	[1,0,0,0,0,0,1,0,0,0,0,1,1,1,1,1,1,0,0,0,0,1,0,0,0,0,1,0,0,0,0,0,1,1,1,1,1,1,1,1,1,1,1,1,2,2,2,1,1,1],
	[1,0,0,0,0,0,1,0,47,0,0,1,1,1,1,1,1,0,0,0,0,1,0,0,0,0,1,0,0,0,0,0,1,1,1,1,1,1,1,1,1,1,1,1,0,0,0,1,1,1],
	[1,0,0,0,0,0,1,0,0,76,0,0,1,1,1,1,1,0,0,0,0,1,0,16,38,0,0,0,0,0,0,0,1,1,1,1,1,1,1,1,1,1,1,1,0,0,0,1,1,1],
	[1,0,0,0,0,0,1,0,0,0,0,0,0,1,0,1,1,0,0,26,0,1,0,67,0,0,0,0,0,0,0,0,1,1,1,1,1,1,1,1,1,1,1,1,0,0,0,1,1,1],
	[1,0,0,0,0,0,1,1,0,0,0,0,0,0,1,1,1,0,0,0,0,1,0,0,0,0,0,37,0,0,0,0,1,1,1,1,1,1,1,1,1,1,1,1,0,0,0,1,1,1],
	[1,0,0,0,0,0,1,1,1,0,0,22,46,0,0,1,1,0,0,0,0,1,0,0,0,0,0,15,66,0,0,0,1,1,1,1,1,1,1,1,1,1,1,1,0,0,0,1,1,1],
	[1,0,0,0,0,0,1,1,1,1,0,0,75,0,0,0,1,0,0,0,0,1,1,0,0,0,0,0,0,0,0,1,1,1,1,1,1,1,1,1,1,1,1,1,0,0,0,1,1,1],
	[1,0,0,0,0,0,1,1,1,1,1,0,0,0,0,0,1,0,0,0,0,1,1,1,0,0,0,0,0,0,1,1,1,1,1,1,1,1,1,1,1,1,1,1,0,0,0,1,1,1],
	[1,0,0,0,0,0,1,1,1,1,1,0,0,0,0,0,1,0,79,0,0,1,1,1,1,1,1,1,1,1,1,1,1,1,1,1,1,1,1,1,1,1,1,0,0,0,62,1,1,1],
	[1,0,0,0,72,0,1,1,1,1,1,0,0,0,0,0,1,0,0,50,0,0,0,0,0,5,0,1,1,1,1,1,1,1,1,1,1,1,1,1,1,1,0,0,0,0,0,1,1,1],
	[1,0,0,0,43,0,0,1,1,1,0,0,0,45,0,0,1,0,0,0,0,0,0,51,0,5,0,0,0,31,0,1,1,1,1,1,1,1,1,1,1,0,0,0,0,0,0,1,1,1],
	[1,0,0,0,0,0,0,0,0,0,0,0,74,21,0,0,1,0,0,0,27,0,0,0,0,5,0,0,0,0,0,0,0,0,2,2,2,0,0,0,0,0,0,0,0,33,0,1,1,1],
	[1,1,0,0,20,0,0,73,0,0,0,0,0,0,0,1,1,1,0,0,0,80,0,0,28,5,0,0,0,0,0,32,0,0,2,2,2,0,0,0,0,0,0,0,0,11,0,1,1,1],
	[1,1,1,0,0,0,0,0,44,0,0,0,0,0,0,1,1,1,1,0,0,0,0,0,81,5,0,0,0,0,0,0,0,0,2,2,2,0,0,0,0,0,0,61,0,0,1,1,1,1],
	[1,1,1,1,0,0,0,0,0,0,0,0,0,0,1,1,1,1,1,1,0,0,0,0,0,5,0,0,0,0,0,1,1,1,1,1,1,1,1,0,0,0,0,0,0,1,1,1,1,1],
	[1,1,1,1,1,1,1,1,1,1,1,1,1,1,1,1,1,1,1,1,1,1,1,1,1,1,1,1,1,1,1,1,1,1,1,1,1,1,1,1,1,1,1,1,1,1,1,1,1,1]
]